10
14
11111111111111
11111111111111
11111111111111
11111111111111
11111111111111
01111111111111
00011111111110
00011111111110
00011111111110
01111111111111
11 18 0 2 0 0 0 1 